1A####*##*####C3
..####.##.####..
##...######...##
##...#....#...##
##4..#....#..6##
######.##.######
*.....####.....*
###..##..##..###
###..##..##..###
*.....####.....*
######.##.######
##...#....#..5##
##...#....#...##
##...######...##
..####.##.####..
..####*##*####B2
