1A####*##*####C3
..####.##.####..
##...######...##
##...#....#...##
##...#....#...##
######.##.######
*.....####.....*
###..##..##..###
###..##..##..###
*.....####.....*
######.##.######
##...#....#...##
##...#....#...##
##...######...##
..####.##.####..
4D####*##*####B2
